6 8 3 5 1 60
H 1 . . . . A H
. . S S . R . .
T . . 2 . . . .
. . . . . . . .
. . . . . . . .
H . . . . . . H
